1111111111111111111111111
1000001000000000000000001
1000001000000000000000001
1000001000000000000000001
1000001000000000000000001
1000001000000000000000001
1000001000000000000000001
1000001000000000000000001
1000001000000000000000001
1000001000000000000000001
1000001000000000000000001
1000001000000000000000001
1000001000000000000000001
1000001000000000001000001
1000001000000000010000001
1000001000000000100000001
1000001000000001000000001
1000001000000010000000001
1000001000000100000000001
1000000000001000000000001
1000000000010000000000001
1111111111100000111111111
1000000000000000000000000
1000000000000000000000000
1111111111111111111111111