1111111111111111111111111
1000000000000000000000001
1000000000000000000000001
0000000000000000000000001
0000000000000000000000001
0000000000000000000000001
1000000000000000000000001
1000000000000000000000001
1000000000000000000000001
1000000000002000000000001
1000000000002000000000001
1000000000022200000000001
1000000002222222000000001
1000000000022200000000001
1000000000002000000000001
1000000000002000000000001
1000000000000000000000001
1000000000000000000000001
1000000000000000000000001
1000000000000000000000001
1000000000000000000000001
1000000000000000000000001
1000000000000000000000001
1000000000000000000000001
1111111111111111111111111