1111111111111111111111111
1000000000000000000000001
1000000000000000000000001
1000000000010000000000001
1000000000000000000000001
1000000000000000000000001
1000000000000000000000001
1000000000000000000000001
1000000000000000000000001
1000000000001000000000001
1000000000001000000000001
1000000000011100000000001
1000000001111111000000001
1000000000011100000000001
1000000000001000000000001
1000000000001000000000001
1000000000000000000000001
1000000000000000000000001
1000000000000000000000001
1000000000000000000000001
1000000000000000000000001
1000000000000000000000000
1000000000000000000000000
1000000000000000000000000
1111111111111111111111111