00000000000000
00000000000000
00000000000000
00000000000000
11111111111111
11111111111111
11110000000111
11100000011111
11121111111111