1111111111
1000000001
100000P001
1000000001
1000000001
100000F001
1111111111