1111111111111111111111111
1010000000000000000000001
1000010000000000000000001
1000000000000000000000001
1000000000000000000000001
1000001000000000000000001
1000000000000000000000001
1000000000000000000000001
1000000000000000000000001
1000000000000000000000001
1000000000000000000000001
1000000000000000000000001
1000000000000000000000001
1000000000000000000000001
1000000000000000000000001
1000000000010000000000001
1000000000000000000000001
1000000000000000000000001
1000000000000000000000001
1000000000000000000000001
1000000000000000000000001
1000000000000000000000000
1000000000000000000000000
1000000000000000000000000
1111111111111111111111111